25 10 10 10 10 10 10 10 10 10 10 10 10 10 10 10 10 10 10 10 10 10 10 10 10 10 10 10 10 10 10 10 10 10 10 10 10 10 10 10 10 10 10 10 10 10 10 10 10 25
25 4 5 20 21 22 6 6 12 23 24 12 6 0 0 0 0 0 0 0 1 1 1 1 1 1 1 1 1 1 4 5 0 0 6 0 0 6 12 23 24 12 6 6 20 21 22 4 5 25
25 14 15 32 33 16 0 0 26 23 24 12 4 5 0 6 4 5 0 0 8 20 22 4 5 2 6 27 28 7 14 15 6 0 4 5 0 0 12 23 24 26 8 0 0 30 31 14 15 25
25 2 18 42 43 16 0 0 12 23 24 12 14 15 6 0 14 15 6 0 8 32 33 14 15 4 5 37 38 7 0 6 0 6 14 15 0 0 12 23 24 12 8 2 6 40 41 16 18 25
25 6 18 4 5 16 17 17 12 23 24 26 6 0 16 0 0 6 0 0 8 42 43 6 2 14 15 17 17 7 0 0 0 0 6 0 0 6 12 23 24 12 32 33 4 5 16 13 18 25
25 16 18 14 15 16 19 19 12 23 24 12 4 5 16 0 0 4 5 0 8 17 17 18 0 0 13 18 0 7 0 4 5 0 0 0 4 5 26 23 24 12 42 43 14 15 16 19 19 25
25 16 6 30 31 16 0 0 12 23 24 12 14 15 16 18 6 14 15 6 8 6 0 16 17 17 18 0 0 7 0 14 15 0 0 6 14 15 12 23 24 12 17 17 17 17 18 0 6 25
25 16 2 40 41 16 0 0 12 23 24 12 17 17 13 18 0 0 0 0 8 30 31 0 16 18 27 28 0 7 0 0 6 0 17 17 6 0 12 23 24 12 19 19 19 19 27 28 2 25
25 19 19 19 19 19 4 5 12 23 24 12 19 19 18 0 0 6 6 0 8 40 41 0 16 18 37 38 6 7 0 0 4 5 16 18 0 0 26 23 24 12 4 5 6 0 37 38 0 25
25 20 21 22 6 6 14 15 12 23 24 12 0 0 16 6 0 0 0 0 1 1 1 1 16 18 1 1 1 1 0 6 14 15 16 18 0 6 12 23 24 12 14 15 2 6 20 21 22 25
25 27 28 4 5 20 21 22 12 23 24 12 6 0 16 0 0 6 0 0 20 21 22 6 16 18 6 20 21 22 0 0 17 17 13 18 6 0 12 23 24 26 1 1 1 1 1 1 1 25
25 37 38 14 15 6 2 0 12 23 24 12 4 5 16 17 18 4 5 0 6 20 21 22 16 18 20 21 22 6 16 13 18 4 5 0 0 0 12 23 24 12 4 5 27 28 20 21 22 25
25 17 17 17 17 17 17 17 12 23 24 12 14 15 6 16 18 14 15 0 20 21 22 6 16 18 6 20 21 22 16 18 6 14 15 6 0 0 12 23 24 12 14 15 37 38 16 18 6 25
25 0 0 19 19 19 13 19 12 23 24 12 12 12 12 12 12 12 12 12 12 12 12 12 12 12 12 12 12 12 12 12 12 12 12 12 12 12 12 23 24 12 8 16 13 13 13 18 6 25
25 6 4 5 32 33 18 0 12 23 24 12 12 12 12 12 12 12 12 12 12 12 12 12 12 12 12 12 12 12 12 12 12 12 12 12 12 12 12 23 24 12 8 16 32 33 0 4 5 25
25 6 14 15 42 43 18 0 12 23 24 12 6 0 0 20 21 22 6 20 21 22 6 20 21 22 6 20 21 22 6 20 21 22 6 20 21 22 12 23 24 12 17 13 42 43 0 14 15 25
25 0 2 0 16 13 18 0 26 23 24 12 32 33 2 0 0 0 0 16 27 28 6 4 5 0 0 2 32 33 0 0 7 18 2 6 4 5 12 23 24 12 19 13 18 6 2 0 6 25
25 0 0 16 18 0 2 6 12 23 24 12 42 43 4 5 6 0 16 18 37 38 0 14 15 0 4 5 42 43 0 6 7 18 30 31 14 15 26 23 24 12 6 8 16 18 6 0 0 25
25 0 19 19 4 5 30 31 12 23 24 12 2 0 14 15 0 0 16 18 0 0 0 0 0 6 14 15 17 17 1 1 1 18 40 41 2 6 12 23 24 12 4 5 8 16 18 30 31 25
25 20 21 22 14 15 40 41 12 23 24 12 17 17 17 17 17 17 13 13 17 17 17 17 17 17 17 17 13 13 17 17 17 13 17 17 17 17 12 23 24 12 14 15 0 8 18 40 41 25
25 1 1 1 1 1 1 1 12 23 24 26 19 19 19 19 19 19 19 19 19 19 19 19 19 19 19 19 19 19 19 19 19 19 19 19 19 19 12 23 24 12 0 0 0 1 1 1 1 25
25 27 28 4 5 6 0 18 12 23 24 12 0 0 0 0 4 5 30 31 0 2 0 6 0 32 33 4 5 0 27 28 6 0 4 5 0 6 12 23 24 12 11 11 11 11 11 11 11 25
25 37 38 14 15 16 13 18 12 23 24 12 4 5 6 2 14 15 40 41 6 0 0 0 0 42 43 14 15 0 37 38 0 2 14 15 0 0 12 23 24 12 11 6 30 31 0 32 33 25
25 16 17 17 17 18 0 0 12 23 24 12 14 15 20 21 22 6 20 21 22 6 20 21 22 6 20 21 22 6 20 21 22 6 20 21 22 0 12 23 24 12 11 0 40 41 6 42 43 25
25 0 6 16 18 0 0 7 12 23 24 12 12 12 12 12 12 12 12 12 12 12 12 12 12 12 12 12 12 12 12 12 12 12 12 12 12 12 12 23 24 26 17 17 17 17 17 17 17 25
25 27 28 16 20 21 22 7 12 23 24 12 12 12 12 12 12 12 12 12 12 12 12 12 12 12 12 12 12 12 12 12 12 12 12 12 12 12 12 23 24 12 19 19 19 19 19 19 19 25
25 37 38 16 13 18 6 7 12 23 24 12 1 1 1 1 1 30 31 1 1 1 27 28 1 1 1 1 1 1 1 1 30 31 1 1 4 5 12 23 24 12 11 6 0 0 6 27 28 25
25 4 5 6 16 32 33 7 12 23 24 12 1 1 1 4 5 40 41 0 0 0 37 38 0 0 0 0 0 0 4 5 40 41 2 6 14 15 12 23 24 12 11 32 33 0 0 37 38 25
25 14 15 2 19 42 43 7 12 23 24 12 17 17 17 14 15 0 0 6 2 4 5 0 0 2 6 32 33 0 14 15 0 0 0 0 27 28 12 23 24 12 11 42 43 6 20 21 22 25
25 1 1 1 1 1 1 7 12 23 24 12 32 33 16 1 1 1 6 1 1 14 15 1 1 6 1 42 43 1 1 1 1 1 6 1 37 38 12 23 24 12 11 11 11 11 11 11 11 25
25 11 11 11 11 11 11 11 12 23 24 12 42 43 16 17 17 17 17 17 17 17 17 17 17 17 17 17 17 17 17 17 17 17 17 17 17 17 26 23 24 12 1 1 1 1 1 1 1 25
25 11 6 4 5 4 5 11 12 23 24 12 4 5 16 19 19 13 13 19 19 19 19 13 13 19 19 19 19 19 19 19 19 19 19 19 19 19 12 23 24 12 8 27 28 2 4 5 7 25
25 11 6 14 15 14 15 11 26 23 24 12 14 15 0 30 31 19 19 6 0 4 5 19 19 0 27 28 0 0 0 6 0 4 5 0 32 33 12 23 24 12 8 37 38 17 14 15 7 25
25 11 32 33 17 32 33 11 12 23 24 12 1 6 1 40 41 1 1 1 1 14 15 1 6 1 37 38 1 1 1 1 1 14 15 1 42 43 12 23 24 12 8 17 17 13 18 6 7 25
25 11 42 43 13 42 43 11 12 23 24 12 12 12 12 12 12 12 12 12 12 12 12 12 12 12 12 12 12 12 12 12 12 12 12 12 12 12 12 23 24 26 17 18 0 20 21 22 7 25
25 11 30 31 13 27 28 11 12 23 24 12 12 12 12 12 12 12 12 12 12 12 12 12 12 12 12 12 12 12 12 12 12 12 12 12 12 12 12 23 24 12 19 18 6 0 32 33 7 25
25 11 40 41 13 37 38 11 12 23 24 12 11 11 11 11 11 11 11 11 11 11 11 16 18 11 11 11 11 11 16 18 11 11 11 11 11 11 26 23 24 12 8 16 13 18 42 43 7 25
25 11 17 17 13 17 17 17 12 23 24 12 11 20 21 22 0 0 27 28 0 6 17 18 6 11 4 5 27 28 16 18 8 4 5 32 33 11 12 23 24 12 8 30 31 16 13 18 7 25
25 11 6 20 21 22 6 6 12 23 24 26 11 0 4 5 17 17 37 38 0 16 18 0 0 11 14 15 37 38 16 18 8 14 15 42 43 11 26 23 24 12 8 40 41 6 16 18 7 25
25 11 11 11 11 11 11 11 12 23 24 12 11 2 14 15 19 19 19 17 17 18 6 0 0 11 0 6 17 17 13 18 8 0 0 0 6 11 12 23 24 12 1 1 1 1 1 1 1 25
25 6 0 0 6 27 28 6 12 23 24 12 11 0 6 0 0 6 0 16 18 0 20 21 22 11 0 0 19 19 13 13 17 17 1 1 1 11 12 23 24 12 4 5 27 28 20 21 22 25
25 20 21 22 0 37 38 0 12 23 24 12 11 4 5 32 33 0 0 16 6 0 27 28 0 11 0 30 31 6 16 13 13 13 17 17 17 11 26 23 24 12 14 15 37 38 6 4 5 25
25 0 17 17 17 17 17 17 12 23 24 12 11 14 15 42 43 17 17 13 17 17 37 38 0 11 6 40 41 0 16 13 19 19 19 13 19 11 12 23 24 12 0 0 0 16 18 14 15 25
25 6 16 32 33 6 16 19 12 23 24 12 11 0 0 17 17 19 6 16 13 13 17 17 0 11 0 0 6 16 13 18 30 31 7 18 6 11 12 23 24 26 17 17 17 18 20 21 22 25
25 6 16 42 43 16 18 0 12 23 24 12 11 4 5 13 18 0 0 16 13 19 19 19 0 11 0 2 0 16 18 8 40 41 7 18 0 11 12 23 24 12 19 19 19 18 6 4 5 25
25 2 19 19 19 20 21 22 26 23 24 12 11 14 15 6 0 0 0 16 18 0 6 0 0 11 0 0 16 13 18 20 21 22 16 18 0 11 12 23 24 12 6 0 6 16 0 14 15 25
25 6 0 0 6 0 2 6 12 23 24 12 11 0 2 0 20 21 22 16 18 0 4 5 0 11 6 0 6 16 13 18 0 16 18 0 6 11 12 23 24 26 32 33 2 16 20 21 22 25
25 4 5 4 5 4 5 6 12 23 24 12 11 4 5 0 4 5 30 31 16 18 14 15 2 11 32 33 0 0 7 16 17 18 0 27 28 11 12 23 24 12 42 43 6 16 17 30 31 25
25 14 15 14 15 14 15 6 12 23 24 12 11 14 15 0 14 15 40 41 16 18 6 0 0 11 42 43 0 2 6 7 16 18 6 37 38 11 12 23 24 12 20 21 22 6 19 40 41 25
25 9 9 9 9 9 9 9 9 9 9 9 9 9 9 9 9 9 9 9 9 9 9 9 9 9 9 9 9 9 9 9 9 9 9 9 9 9 9 9 9 9 9 9 9 9 9 9 9 25
