25 10 10 10 10 10 10 10 10 10 10 10 10 10 10 10 10 10 10 10 10 10 10 10 10 10 10 10 10 10 10 10 10 10 10 10 10 10 10 10 10 10 10 10 10 10 10 10 10 25
25 6 30 31 0 2 4 5 27 28 6 20 21 22 2 4 5 27 28 6 6 6 26 23 24 12 20 21 21 22 4 5 20 21 21 22 32 33 20 21 21 22 4 5 4 5 8 32 33 25
25 0 40 41 6 0 14 15 37 38 4 5 6 0 0 14 15 37 38 17 17 17 12 23 24 12 4 5 27 28 14 15 17 17 17 0 42 43 0 0 0 0 14 15 14 15 18 42 43 25
25 4 5 8 16 17 17 17 17 6 14 15 2 0 6 2 6 17 17 19 19 19 12 23 24 12 14 15 37 38 0 16 18 0 16 17 17 17 17 17 17 17 17 17 17 17 18 1 1 25
25 14 15 8 16 18 32 33 4 5 2 30 31 20 21 22 16 13 13 1 1 1 12 23 24 26 17 17 17 19 19 19 0 30 31 0 19 19 13 13 19 19 19 19 13 0 0 27 28 25
25 2 6 8 16 18 42 43 14 15 6 40 41 6 6 17 18 7 13 8 6 6 12 23 24 12 19 19 19 0 0 0 0 40 41 20 22 0 16 18 0 0 4 5 16 6 2 37 38 25
25 6 0 2 16 18 0 20 21 22 17 17 17 17 19 19 0 7 13 13 8 6 12 23 24 12 20 21 22 6 20 21 21 22 0 0 0 0 16 18 0 0 14 15 16 1 1 20 22 25
25 20 21 22 6 19 19 19 19 19 19 19 19 19 32 33 0 7 19 19 13 8 12 23 24 12 11 11 11 11 11 11 11 11 11 11 11 11 16 18 11 11 11 11 11 11 11 11 11 25
25 27 28 4 5 6 0 0 0 0 0 6 0 6 42 43 4 5 0 0 16 8 26 23 24 12 11 6 17 17 17 27 28 0 2 0 4 5 16 18 6 32 33 20 22 4 5 6 2 25
25 37 38 14 15 20 21 22 6 2 4 5 20 21 22 2 14 15 0 0 16 8 12 23 24 12 11 30 31 0 13 37 38 6 13 6 14 15 16 18 6 42 43 20 22 14 15 2 6 25
25 6 1 1 1 1 1 1 2 6 14 15 2 0 6 0 1 1 1 1 16 8 12 23 24 12 11 40 41 0 13 17 17 17 13 17 17 17 13 13 17 17 17 17 17 17 17 17 17 25
25 11 11 11 11 11 11 11 11 11 11 11 11 11 11 11 11 11 11 17 13 8 12 23 24 12 11 0 0 0 0 0 0 0 27 28 16 0 0 0 6 0 0 13 0 2 6 0 0 25
25 11 27 28 6 0 30 31 0 0 0 0 4 5 2 20 22 16 19 19 19 8 12 23 24 12 11 2 4 5 32 33 6 0 37 38 16 1 1 1 1 1 1 13 0 6 2 0 0 25
25 11 37 38 0 17 40 41 0 0 32 33 14 15 6 17 17 13 1 1 6 11 12 23 24 26 11 6 14 15 42 43 2 0 0 0 16 8 20 21 21 22 7 13 0 0 0 0 0 25
25 11 0 4 5 19 19 17 17 17 42 43 6 17 17 13 1 1 6 27 28 11 12 23 24 12 11 11 11 11 11 11 11 11 11 11 16 11 11 11 11 11 11 13 11 11 11 11 11 25
25 11 2 14 15 0 0 16 19 19 19 19 19 13 18 20 22 4 5 37 38 11 12 23 24 12 1 1 1 1 1 1 1 1 1 1 16 20 21 21 21 21 22 13 0 0 0 20 22 25
25 11 6 0 30 31 16 18 6 2 4 5 6 19 18 32 33 14 15 2 6 11 12 23 24 12 8 0 0 0 32 33 0 0 0 6 16 13 13 13 13 13 13 13 13 4 5 6 0 25
25 11 0 6 40 41 16 18 2 0 14 15 2 6 16 42 43 6 2 4 5 11 12 23 24 12 8 20 22 0 42 43 0 30 31 0 16 18 7 6 0 0 4 5 13 14 15 2 0 25
25 11 20 21 22 6 16 18 20 21 21 21 21 22 16 18 20 21 22 14 15 11 12 23 24 12 8 6 2 0 0 0 0 40 41 0 16 18 7 0 6 0 14 15 13 13 32 33 0 25
25 11 11 11 11 11 16 18 11 11 11 11 11 11 16 18 11 11 11 11 11 11 12 23 24 26 1 1 1 6 0 0 1 1 1 1 16 18 7 4 5 0 2 27 28 13 42 43 2 25
25 8 32 33 4 5 16 18 0 0 32 33 4 5 16 18 0 6 4 5 2 7 12 23 24 12 8 6 0 0 0 4 5 17 17 17 13 18 7 14 15 0 0 37 38 0 4 5 0 25
25 8 42 43 14 15 16 18 0 0 42 43 14 15 16 18 0 6 14 15 16 7 12 23 24 12 8 0 0 27 28 14 15 13 13 13 13 18 7 0 0 6 0 6 0 0 14 15 6 25
25 8 0 0 2 6 16 18 0 4 5 0 2 0 0 18 0 20 21 22 16 7 12 23 24 12 8 30 31 37 38 0 0 13 18 1 1 1 7 2 0 0 0 30 31 6 0 0 0 25
25 8 0 0 6 16 13 18 0 14 15 0 0 6 0 18 0 0 30 31 16 7 12 23 24 12 8 40 41 0 0 0 0 13 18 8 20 21 21 21 21 22 6 40 41 0 0 0 2 25
25 8 2 27 28 16 0 0 0 6 20 21 22 6 0 0 4 5 40 41 16 17 26 23 24 12 6 1 1 1 1 1 6 13 13 13 13 13 13 13 13 13 13 13 13 13 2 27 28 25
25 8 6 37 38 16 0 30 31 16 17 17 17 4 5 0 14 15 0 6 16 19 12 23 24 12 0 0 6 0 6 0 17 18 0 0 0 0 0 13 13 13 0 13 0 13 6 37 38 25
25 8 0 0 0 16 18 40 41 16 4 5 18 14 15 6 32 33 4 5 16 7 12 23 24 12 17 17 17 17 17 17 13 18 8 4 5 4 5 1 1 1 1 1 1 1 1 32 33 25
25 8 20 22 6 2 19 19 19 18 14 15 19 19 18 2 42 43 14 15 16 7 12 23 24 12 20 21 21 21 22 6 0 18 8 14 15 14 15 0 6 2 6 0 20 21 22 42 43 25
25 8 32 33 4 5 6 0 0 16 13 18 27 28 19 19 19 19 19 19 19 7 12 23 24 12 0 20 21 22 2 0 16 18 1 1 1 1 1 1 6 0 32 33 6 1 1 1 17 25
25 8 42 43 14 15 20 21 22 16 13 18 37 38 6 0 2 20 21 22 0 7 12 23 24 12 30 31 0 0 16 13 13 13 17 17 17 17 17 17 8 0 42 43 7 16 17 17 13 25
25 1 1 1 1 1 1 1 1 1 16 18 1 1 1 1 1 1 1 1 1 1 26 23 24 12 40 41 16 13 18 6 1 1 1 1 1 1 6 16 1 1 1 1 1 16 19 19 19 25
25 4 5 30 31 20 21 22 6 0 16 18 20 21 22 6 20 21 22 6 4 5 12 23 24 12 6 7 16 18 27 28 0 0 6 0 32 33 2 16 17 17 0 0 16 18 27 28 0 25
25 14 15 40 41 0 0 6 0 0 16 13 17 17 17 17 17 17 17 2 14 15 12 23 24 12 1 7 16 18 37 38 0 20 21 22 42 43 0 6 6 16 17 17 13 18 37 38 0 25
25 0 0 17 17 17 17 17 17 17 13 13 19 19 19 19 19 19 19 30 31 0 12 23 24 12 8 2 6 4 5 1 1 1 1 1 4 5 0 0 8 7 16 13 13 0 7 4 5 25
25 6 16 13 13 13 13 13 13 13 13 18 0 27 28 0 20 21 22 40 41 2 12 23 24 12 8 6 2 14 15 8 20 21 22 7 14 15 6 2 8 0 0 16 18 1 1 14 15 25
25 2 0 6 16 13 18 0 16 18 6 16 18 37 38 16 17 17 17 4 5 6 12 23 24 26 1 1 1 1 1 8 20 21 22 7 1 1 1 1 8 0 0 16 18 0 0 2 6 25
25 27 28 0 16 18 0 6 16 18 0 16 13 18 0 16 13 19 19 14 15 0 12 23 24 12 11 11 11 11 11 11 11 11 11 11 11 11 11 11 11 11 11 16 18 11 11 11 11 25
25 37 38 16 18 0 6 0 16 18 0 27 28 16 17 13 18 0 2 0 6 2 12 23 24 12 11 27 28 16 6 0 2 0 4 5 0 0 32 33 4 5 0 16 18 0 0 4 5 25
25 4 5 16 18 32 33 2 16 18 6 37 38 16 13 13 18 6 32 33 4 5 12 23 24 12 11 37 38 16 20 21 22 6 14 15 2 6 42 43 14 15 0 16 18 0 0 14 15 25
25 14 15 6 2 42 43 0 0 20 21 22 16 18 0 0 6 2 42 43 14 15 26 23 24 12 11 17 17 13 17 17 17 17 17 17 17 17 17 17 17 17 17 13 18 0 32 33 6 25
25 11 11 11 11 11 11 11 11 11 11 11 16 18 11 11 11 11 11 11 11 11 12 23 24 12 11 20 21 22 19 13 13 19 19 19 13 13 19 19 19 19 19 13 18 0 42 43 6 25
25 11 30 31 6 4 5 32 33 2 4 5 16 18 6 27 28 4 5 30 31 11 12 23 24 12 11 4 5 0 0 16 18 6 4 5 16 18 30 31 0 6 0 16 13 18 0 0 0 25
25 11 40 41 2 14 15 42 43 6 14 15 16 18 2 37 38 14 15 40 41 11 12 23 24 12 11 14 15 6 0 16 18 2 14 15 16 18 40 41 4 5 0 16 13 18 0 4 5 25
25 11 17 17 17 17 17 17 17 17 17 17 13 13 17 17 17 17 17 17 17 17 12 23 24 12 11 2 6 17 17 13 18 0 0 0 16 18 6 0 14 15 2 0 0 13 18 14 15 25
25 11 19 19 19 19 19 19 19 19 19 19 19 19 19 19 19 19 19 19 19 19 12 23 24 26 11 0 16 13 13 18 4 5 0 0 16 18 0 4 5 6 0 0 6 16 13 18 0 25
25 11 4 5 32 33 0 0 4 5 30 31 0 0 4 5 27 28 0 4 5 11 12 23 24 12 11 30 31 20 21 22 14 15 0 6 16 18 0 14 15 0 4 5 27 28 19 19 0 25
25 11 14 15 42 43 6 0 14 15 40 41 0 2 14 15 37 38 6 14 15 11 12 23 24 12 11 40 41 6 6 2 6 0 0 0 0 0 6 0 0 0 14 15 37 38 0 0 6 25
25 11 20 22 6 20 21 22 6 20 21 22 6 20 21 22 6 20 21 22 6 11 12 23 24 12 11 20 21 21 21 20 21 22 20 21 22 20 21 22 20 21 22 20 21 22 20 21 22 25
25 11 1 1 1 1 1 1 1 1 1 1 1 1 1 1 1 1 1 1 1 11 26 23 24 12 11 1 1 1 1 1 1 1 1 1 1 1 1 1 1 1 1 1 1 1 1 1 1 25
25 9 9 9 9 9 9 9 9 9 9 9 9 9 9 9 9 9 9 9 9 9 9 9 9 9 9 9 9 9 9 9 9 9 9 9 9 9 9 9 9 9 9 9 9 9 9 9 9 25
