25 25 25 25 25 25 25 25 25 25 25 25 25 25 25 25 25 25 25 25 25 25 25 25 25 25 25 25 25 25 25 25 25 25 25 25 25 25 25 25 25 25 25 25 25 25 25 25 25 25
25 0 0 0 0 0 0 0 0 4 5 0 0 0 0 0 0 6 0 0 0 0 7 12 23 24 12 8 4 5 0 0 0 0 0 0 0 0 0 0 0 0 0 0 0 6 0 4 5 25
25 0 6 0 4 5 6 0 0 14 15 0 6 0 0 4 5 0 0 4 5 0 7 12 23 24 12 8 14 15 0 0 0 6 0 0 0 0 0 0 0 6 0 0 4 5 0 14 15 25
25 0 0 0 14 15 0 0 0 0 0 0 0 0 0 14 15 6 0 14 15 0 7 12 23 24 12 8 0 0 0 0 0 0 0 0 0 0 0 4 5 0 0 0 14 15 0 0 0 25
25 0 0 0 0 0 0 0 6 4 5 6 0 0 0 0 0 0 0 0 0 6 7 12 23 24 12 8 0 6 0 0 4 5 0 0 0 0 0 14 15 0 0 0 0 0 0 0 0 25
25 0 0 6 6 0 6 6 0 14 15 0 6 4 5 0 0 0 6 0 0 0 7 12 23 24 12 8 0 0 4 5 14 15 0 0 6 4 5 0 0 0 20 21 22 0 0 0 0 25
25 4 5 0 0 4 5 0 20 21 22 0 0 14 15 0 0 0 0 4 5 0 7 12 23 24 12 8 0 6 14 15 6 4 5 6 0 14 15 6 0 0 0 0 0 6 0 0 0 25
25 14 15 0 0 14 15 0 0 0 27 28 0 0 6 0 0 4 5 14 15 0 7 12 23 24 12 8 6 2 0 0 0 14 15 0 0 0 0 0 6 0 0 0 0 0 0 0 6 25
25 6 0 0 0 0 0 0 0 0 37 38 2 26 6 0 0 14 15 0 0 6 7 26 23 24 12 8 0 0 0 0 0 0 0 0 0 0 0 0 0 6 0 0 0 0 0 6 0 25
25 0 0 30 31 0 0 0 16 18 0 0 0 0 0 6 0 0 0 0 0 0 7 12 23 24 12 8 0 0 0 0 0 32 33 0 0 20 22 0 0 4 5 0 0 0 0 0 0 25
25 0 2 40 41 26 0 0 16 18 1 1 1 1 1 1 1 1 1 1 1 1 1 12 23 24 12 1 1 1 1 1 0 42 43 0 0 0 0 0 0 14 15 0 0 4 5 0 0 25
25 0 0 0 0 0 0 0 16 13 17 17 17 17 17 17 17 17 17 17 17 17 17 12 23 24 12 17 17 17 17 17 17 17 17 17 13 0 2 6 0 0 6 0 0 14 15 0 0 25
25 4 5 0 0 0 0 0 16 13 19 19 19 19 19 19 19 19 19 19 19 19 19 12 23 24 12 19 19 19 19 19 13 13 12 12 26 0 0 0 0 0 6 0 0 0 0 0 0 25
25 14 15 0 20 21 22 0 16 18 0 0 0 0 4 5 0 0 4 5 0 0 7 12 23 24 12 1 1 1 1 1 16 13 12 12 12 0 0 0 0 0 0 6 0 0 0 0 0 25
25 0 0 0 0 0 0 0 16 18 0 0 0 0 14 15 6 6 14 15 0 0 7 12 23 24 12 8 20 22 27 28 16 13 26 12 26 0 0 30 31 0 0 4 5 0 0 4 5 25
25 6 0 0 6 4 5 0 16 18 0 0 0 0 0 0 32 33 2 6 0 0 7 12 23 24 12 8 4 5 37 38 0 0 0 0 0 0 0 40 41 0 0 14 15 0 0 14 15 25
25 0 6 6 0 14 15 6 16 18 0 0 0 0 0 0 42 43 26 6 0 0 7 12 23 24 12 8 14 15 0 0 0 0 0 0 0 0 0 0 0 0 0 0 0 6 0 0 0 25
25 0 0 0 0 0 0 0 16 18 20 21 22 0 0 0 0 0 0 0 6 0 7 12 23 24 26 8 0 0 0 2 0 0 0 20 21 22 0 0 0 0 2 6 0 0 6 4 5 25
25 0 0 0 0 0 0 0 16 18 0 0 0 0 0 0 0 0 0 0 4 5 7 12 23 24 12 8 0 6 0 0 0 0 0 0 0 0 4 5 0 0 0 4 5 0 0 14 15 25
25 0 30 31 2 0 0 0 16 18 0 0 0 0 0 0 0 0 0 0 14 15 7 12 23 24 12 8 4 5 0 0 0 0 0 4 5 0 14 15 0 0 0 14 15 0 0 0 0 25
25 0 40 41 0 20 21 22 16 18 0 0 0 0 4 5 0 0 2 0 0 6 7 12 23 24 12 8 14 15 0 0 0 0 0 14 15 6 0 0 6 6 4 5 0 0 0 0 0 25
25 0 0 0 12 26 12 12 12 12 0 0 0 0 14 15 27 28 0 0 0 6 7 12 23 24 12 8 0 0 6 6 16 18 8 0 0 0 0 0 0 0 14 15 0 0 0 6 0 25
25 0 0 0 12 12 12 12 12 12 0 0 0 0 0 0 37 38 0 0 4 5 7 12 23 24 12 8 0 2 0 7 16 18 8 0 0 0 0 0 0 6 0 0 6 4 5 0 6 25
25 0 0 0 0 0 0 0 12 12 12 12 26 0 0 0 0 0 0 0 14 15 7 12 23 24 12 8 0 20 22 7 16 18 8 0 0 0 0 0 0 0 0 0 0 14 15 0 6 25
25 6 0 0 0 0 0 0 12 12 12 12 12 0 0 0 0 0 4 5 6 0 7 12 23 24 12 8 0 26 12 17 16 18 8 0 0 0 0 0 0 0 0 0 0 0 0 0 0 25
25 0 0 4 5 0 0 0 26 12 0 0 0 0 2 0 0 0 14 15 0 0 7 12 23 24 12 8 6 12 12 19 16 18 8 0 32 33 0 0 0 0 0 0 0 2 0 0 0 25
25 0 6 14 15 0 0 0 0 0 0 0 0 0 0 0 0 0 0 4 5 0 7 26 23 24 12 8 0 27 28 7 16 18 8 0 42 43 0 0 0 0 0 0 0 27 28 0 6 25
25 0 0 0 2 4 5 0 0 0 4 5 0 0 0 0 0 0 2 14 15 0 7 12 23 24 12 8 0 37 38 7 16 18 8 0 0 0 0 0 0 12 26 0 0 37 38 0 0 25
25 0 0 0 0 14 15 0 0 0 14 15 0 0 20 21 22 0 0 0 6 0 7 12 23 24 12 1 1 1 1 1 16 18 1 1 1 1 1 1 0 12 12 0 0 0 0 0 6 25
25 0 20 21 22 0 6 0 0 6 0 0 0 0 0 0 30 31 12 12 6 0 7 12 23 24 12 17 17 17 17 17 13 13 17 17 17 17 17 17 17 12 12 12 12 26 0 4 5 25
25 0 0 0 0 0 0 0 6 0 0 0 0 0 0 0 40 41 12 26 1 1 1 12 23 24 12 19 19 19 19 19 19 19 19 19 13 13 19 19 19 12 12 12 12 12 6 14 15 25
25 9 9 9 9 9 9 9 9 9 9 0 0 0 12 12 12 12 12 12 17 17 17 12 23 24 12 1 1 1 1 1 1 1 1 1 16 18 1 1 1 1 1 1 1 1 1 1 1 25
25 0 6 0 4 5 0 0 0 0 6 0 0 0 12 12 12 12 12 12 19 19 19 12 23 24 12 8 0 6 0 0 32 33 4 5 16 18 4 5 0 0 0 0 0 0 0 0 0 25
25 0 27 28 14 15 12 26 32 33 0 6 0 0 0 4 5 0 0 0 1 1 1 12 23 24 12 8 0 0 2 0 42 43 14 15 12 26 14 15 0 0 0 0 2 0 6 0 0 25
25 6 37 38 12 26 12 12 42 43 0 4 5 0 0 14 15 0 0 0 0 0 7 12 23 24 12 8 6 0 0 0 0 0 0 0 12 12 0 0 0 30 31 0 0 0 0 4 5 25
25 0 0 0 12 12 12 12 0 0 2 14 15 0 0 0 0 0 0 0 0 0 7 12 23 24 12 8 0 0 20 21 22 0 0 4 5 0 0 0 0 40 41 0 0 20 22 14 15 25
25 0 0 2 0 6 12 12 1 1 1 1 1 1 1 1 1 1 1 1 1 1 1 12 23 24 12 8 4 5 0 0 0 0 0 14 15 6 0 0 0 0 0 0 0 0 0 0 0 25
25 0 20 21 22 17 17 17 17 17 17 17 17 17 17 17 17 17 17 17 17 17 17 12 23 24 26 8 14 15 0 6 0 0 0 0 0 0 0 0 6 0 0 0 0 0 0 6 0 25
25 6 0 0 0 19 19 13 13 19 19 19 19 19 19 19 19 19 19 19 19 19 19 12 23 24 12 8 0 0 4 5 0 4 5 9 9 9 9 9 9 9 9 9 9 9 9 9 9 25
25 0 0 0 0 0 0 16 18 1 1 1 1 1 1 1 1 1 1 1 1 1 1 12 23 24 12 8 0 6 14 15 0 14 15 0 0 6 4 5 6 0 0 0 0 0 0 0 0 25
25 0 0 0 0 0 0 16 18 0 0 0 0 4 5 6 0 0 0 0 0 4 7 12 23 24 12 8 0 0 0 0 6 0 20 21 22 0 14 15 0 20 21 22 0 0 0 0 0 25
25 0 6 4 5 0 0 16 18 0 2 0 0 14 15 0 4 5 0 0 0 14 7 12 23 24 12 8 0 0 4 5 0 0 12 12 12 0 32 33 0 12 12 12 0 0 4 5 0 25
25 6 0 14 15 0 0 12 12 0 32 33 0 0 0 0 14 15 6 0 0 0 7 12 23 24 12 8 0 6 14 15 0 0 26 12 26 0 42 43 0 26 12 26 0 0 14 15 6 25
25 0 27 28 0 0 0 12 26 0 42 43 0 0 0 0 0 4 5 0 0 0 7 12 23 24 12 8 4 5 6 0 0 0 12 12 12 12 12 12 12 12 12 12 0 0 0 4 5 25
25 0 37 38 0 0 2 12 12 12 12 12 27 28 0 0 0 14 15 6 4 5 7 12 23 24 12 8 14 15 0 0 0 2 0 20 21 22 12 12 20 21 22 0 2 0 6 14 15 25
25 0 0 0 0 0 0 12 12 12 26 12 37 38 0 0 0 0 0 0 14 15 7 26 23 24 12 17 17 17 17 17 17 17 17 17 17 17 13 13 0 0 0 0 0 6 0 0 0 25
25 0 4 5 0 0 0 0 0 20 21 22 0 0 4 5 0 0 4 5 6 4 7 12 23 24 12 19 19 19 19 19 19 19 19 19 19 19 13 13 0 0 0 0 6 0 20 22 0 25
25 6 14 15 2 0 0 0 0 0 0 0 0 0 14 15 0 0 14 15 0 14 7 12 23 24 12 1 1 1 1 1 1 1 1 1 1 1 1 1 4 5 6 4 5 0 0 0 0 25
25 20 21 22 6 0 0 0 0 0 0 0 0 0 0 0 0 0 0 6 0 0 7 12 23 24 12 0 0 6 0 0 0 0 0 0 6 0 0 0 14 15 0 14 15 0 0 0 0 25
25 25 25 25 25 25 25 25 25 25 25 25 25 25 25 25 25 25 25 25 25 25 25 25 25 25 25 25 25 25 25 25 25 25 25 25 25 25 25 25 25 25 25 25 25 25 25 25 25 25
